11111111111111111111111111111111
1..............................1
1..............................1
1..............................1
1.....111..............111.....1
1..............................1
1..............................1
1..............................1
1..............................1
1..............................1
1..............................1
1..............................1
1..............................1
1111...........................1
1..............................1
1..1111111111..................1
1..1........1111..1111.........1
1..11111111.1.....1..1.........1
1....111....1.....1..1.........1
1.........111..1111..1111..11111
1..1.111111.1.....1............1
1..1.111111.11111.111..111111111
1..1...........................1
11111111111111111111111111111111



