11111111111111111111111111111111111111111111111111111111111111111111111111111111111111111111111111111111111111111111111111111111111111111111111111111111111111111111111
11111111111111111111111111111111111111111111111111111111111111111111111111111111111111111111111111111111111111111111111111111111111111111111111111111111111111111111111
11111111111111111111111111111111111111111111111111111111111111111111111111111111111111111111111111111111111111111111111111111111111111111111111111111111111111111111111
11111111111111111111111111111111111111111111111111111111111111111111111111110011111111111111111111111111111111111111111111111111111111111111111111111111111111111111111
11111111111111111111111111111111111111111111111111111111111111111111111111110011111111111111111111111111111111111111111111111111111111111111111111111111111111111111111
11111111111111111111111111111111111111111111111111111111111111110000000000000000000000001111111111111111111111111111111111111111111111111111111111111111111111111111111
11111111111111111111111111111111111111111111111111111111111111110000000000000000000000001111111111111111111111111111111111111111111111111111111111111111111111111111111
11111111111111111111111111111111111111111111111111111111111111110000000000000000000000001111111111111111111111111111111111111111111111111111111111111111111111111111111
11111111111111111111111111111111111111111111111111111111111111110001111111111111111110001111111111111111111111111111111111111111111111111111111111111111111111111111111
11111111111111111111111111111111111111111111111111111111111111110001111111111111111110001111111111111111111111111111111111111111111111111111111111111111111111111111111
11111111111111111111111111111111111111111111111111111111111111110001111111111111111110001111111111111111111111111111111111111111111111111111111111111111111111111111111
11111111111111111111111111111111111111111111111111111111111111110001111111111111111110001111111111111111111111111111111111111111111111111111111111111111111111111111111
11111111111111111111111111111111111111111111111111111111111111110001111111111111111110001111111111111111111111111111111111111111111111111111111111111111111111111111111
11111111111111111111111111111111111111111111111111111111111111110001111111111111111110001111111111111111111111111111111111111111111111111111111111111111111111111111111
11111111111111111111111111111111111111111111111111111111111111110001111111111111111110001111111111111111111111111111111111111111111111111111111111111111111111111111111
11111111111111111111111111111111111111111111111111111111111111110001111111111111111110001111111111111111111111111111111111111111111111111111111111111111111111111111111
11111111111111111111111111111111111111111111111111111111111111110001111111100111111110001111111111111111111111111111111111111111111111111111111111111111111111111111111
11111111111111111111111111111111111111111111111111111111111111110001111111100111111110001111111111111111111111111111111111111111111111111111111111111111111111111111111
11111111111111111111111111111111111111111111111111111111111111110001111111000011111110001111111111111111111111111111111111111111111111111111111111111111111111111111111
11111111111111111111111111111111111111111111111111111111111111110001111000000000011110001111111111111111111111111111111111111111111111111111111111111111111111111111111
11111111111111111111111111111111111111111111111111111111111111110001111000000000011110001111111111111111111111111111111111111111111111111111111111111111111111111111111
11111111111111111111111111111111111111111111111111111111111111110001111000000001111110001111111111111111111111111111111111111111111111111111111111111111111111111111111
11111111111111111111111111111111111111111111111111111111111111110001111001000001111110001111111111111111111111111111111111111111111111111111111111111111111111111111111
11111111111111111111111111111111111111111111111111111111111111110001111001000001111110001111111111111111111111111111111111111111111111111111111111111111111111111111111
11111111111111111111111111111111111111111111111111111111111111110001111000000000011110001111111111111111111111111111111111111111111111111111111111111111111111111111111
11111111111111111111111111111111111111111111111111111111111111110001111111111111111110001111111111111111111111111111111111111111111111111111111111111111111111111111111
11111111111111111111111111111111111111111111111111111111111111110001111111111111111110001111111111111111111111111111111111111111111111111111111111111111111111111111111
11111111111111111111111111111111111111111111111111111111111111110001111111111111111110001111111111111111111111111111111111111111111111111111111111111111111111111111111
11111111111111111111111111111111111111111111111111111111111111110001111111111111111110001111111111111111111111111111111111111111111111111111111111111111111111111111111
11111111111111111111111111111111111111111111111111111111111111110001111111100111111110001111111111111111111111111111111111111111111111111111111111111111111111111111111
11111111111111111111111111111111111111111111111111111111111111110001111111100111111110001111111111111111111111111111111111111111111111111111111111111111111111111111111
11111111111111111111111111111111111111111111111111111111111111110000000000000000000000001111111111111111111111111111111111111111111111111111111111111111111111111111111
11111111111111111111111111111111111111111111111111111111111111110000000000000000000000001111111111111111111111111111111111111111111111111111111111111111111111111111111
11111111111111111111111111111111111111111111111111111111111111110000000000000000000000001111111111111111111111111111111111111111111111111111111111111111111111111111111
11111111111111111111111111111111111111111111111111111111111111111111111111111111111111111111111111111111111111111111111111111111111111111111111111111111111111111111111
11111111111111111111111111111111111111111111111111111111111111111111111111111111111111111111111111111111111111111111111111111111111111111111111111111111111111111111111
11111111111111111111111111111111111111111111111111111111111111111111111111111111111111111111111111111111111111111111111111111111111111111111111111111111111111111111111
11111111111111111111111111111111111111111111111111111111111111111111111111111111111111111111111111111111111111111111111111111111111111111111111111111111111111111111111
11111100111111111100111111111110011111111111111111111111111111111111111111111111111111111111111111111111111111111111111111111111111111111111111111111111111111111111111
11111100111111111100111111111110011111111111111111111111111111111111111111111111111111111111111111111111111111111111111111111111111111111111111111111111111111111111111
11000000000000000000000000000000000000000000011111111111111111111111111111111111111111111111111111111111111111111111111111111111111111111111111111111111111111111111111
11000000000000000000000000000000000000000000011111111111111111111111111111111111111111111111111111111111111111111111111111111111111111111111111111111111111111111111111
11000000000000000000000000000000000000000000011111111111111111111111111111111111111111111111111111111111111111111111111111111111111111111111111111111111111111111111111
11000000000000000000000000000000000000000000011111111111111111111111111111111111111111111111111111111111111111111111111111111111111111111111111111111111111111111111111
11000000000000000000000000000000000000000000011111111111111111111111111111111111111111111111111111111111111111111111111111111111111111111111111111111111111111111111111
11000000000000000000000000000000000000000000011111111111111111111111111111111111111111111111111111111111111111111111111111111111111111111111111111111111111111111111111
11000000000000000000000000000000000000000000011111111111111111111111111111111111111111110011111111111110010011111111111111111111111111111111111111111111111111111111111
11000000000000000000000000000000000000000000011111111111111111111111111111111111111111110011111111111110010011111111111111111111111111111111111111111111111111111111111
11000000000000000000000000000000000000000000011111111111111111111111111111111111111111110000000000011110000000000000000000000111111111111111111111111111111111111111111
11000000000000000000000000000000000000000000011111111111111111111111111111111111111111110000000000011110000000000000000000000111111111111111111111111111111111111111111
11000000000000000000000000000000000000000000011111111111111111111111111111111111111111110000000000011110000000000000000000000111111111111111111111111111111111111111111
11000000000000000000000000000000000000000000011111111111111111111111111111111111111111111111111100011111111111111111111111000111111111111111111111111111111111111111111
11000000000000000000000000000000000000000000011111111111111111111111111111111111111111111111111100011111111111111111111111000111111111111111111111111111111111111111111
11000000000000000000000000000000000000000000011111111111111111111111111111111111111111111111111100011111111111111111111111000111111111111111111111111111111111111111111
11000000000000000000000000000000000000000000011111111111111111111111111111111111111111111111111100011111111111111111111111000111111111111111111111111111111111111111111
11000000000000000000000000000000000000000000011111111111111111111111111111111111111111111111100100011111111111111111111111000111111111111111111111111111111111111111111
11000000000000000000000000000000000000000000011111111111111110011111111111111111111111111111100100011111111111111111111001000111111111111111111111111111111111111111111
11000000000000000000000000000000000000000000011111111111111110011111111111111111111111111111100000011111111111111111111001000111111111111111111111111111111111111111111
11000000000000000000000000000000000000000000011111111111111110000000000000000000000011111111100000011111111111111111111000000111111111111111111111111111111111111111111
11000000000000000000000000000000000000000000011111111111111110000000000000000000000011111111100000011111111111111111111000000111111111111111111111111111111111111111111
11000000000000000000000000000000000000000000011111111111111110000000000000000000000011111111111111111111111111111111111000000111111111111111111111111111111111111111111
11111100011111111111111110001111111111000111111100111111111111111111111111111111100011111111111111111111111111111111111111111111111111111111111111111111111111111111111
11111100011111111111111110001111111111000111111100111111111111111111111111111111100011111111111111111111111111111111111111111111111111111111111111111111111111111111111
11111100011111111111111110001111111111000111111100000000000011111111111111111111100011111111111111111111111111111111111111111111111111111111111111111111111111111111111
11111100011111111111111110001111111111000111111100000000000011111111111111111111100011111111111111111111111111111111111111111111111111111111111111111111111111111111111
11111100011111111111111110001111111111000111111100000000000011111111111111111111100011111111111111111111111111110010011111111111111111111111111111111111111111111111111
11111100011111111111111110001111111111000111111100011111100011111111111111111111100011111111111111111111111111110010011111111111111111111111111111111111111111111111111
11111100011111111111111110001111111111000111111100011111100011111111111111111111100011111111111111111111111111110000000000011111111111111111111111111111111111111111111
11111100011111111111111110001111111111000111111100011111100011111111111111111111100011111111111111111111111111110000000000011111111111111111111111111111111111111111111
11111100011111111111111110001111111111000111111100011111100011111111111111111111100011111111110010011111111111110000000000011111111111111111111111111111111111111111111
11111100011111111111111110001111111111000111111100011111100011111111111111111111100011111111110010011111111111111111111100011111111111111111111111111111111111111111111
11111100011111111111111110001111111111000111111100011111100011111111111111111111100011111111110000000000001111111111111100011111111111111111111111111111111111111111111
11111100011111111111111110001111111111000111111100011111100011111111111111111110000011111111110000000000001111111111111100011111111111111111111111111111111111111111111
11111100011111111111111110001111111111000111111100011111100011111111111111111110000011111111110000000000001111111111111100011111111111111111111111111111111111111111111
11111100011111111111111110001111111111000111111100011111100000000000000000000000000011111111111111111110001111111111100100011111111111111111111111111111111111111111111
11111100011111100111111110001111111111000000000100011111100000000000000000000000000011111111111111111110001111111111100100011111111111111111111111111111111111111111111
11111100011111100111111110001111111111000000000100011111100000000000000000000000000011111111111111111110001111111111100000011111111111111111111111111111111111111111111
11111100000000000111111110001111111111000000000000011111111111111111111111111111111111111111111111111110001111111111100000011111111111111111111111111111111111111111111
11111100000000000111111110001111111111000000000000011111111111111111111111111111111111111111111111111110001111111111100000011111111111111111111111111111111111111111111
11111100000000000111111110001111111111000000000000011111111111111111111111111111111111111111111111111110001111111111111111111111111111111111111111111111111111111111111
11111111111111111111111110001111111111000000000000011111111111111111111111111111111111111111111111111110001111111111111111111111111111111111111111111111111111111111111
11111111111111111111111110001111111111000000000000011111111111111111111111111111111111111111111111111110001111111111111111111111111111111111111111111111111111111111111
11111111111111111111111110001111111111000000000000011111111111111111111111111111111111111111111111111110001111111111111111111111111111111111111111111111111111111111111
11111111111111111111111110001111111111010000000000011111111111111111111111111111111111111111111111110010001111111111111111111111111111111111111111111111111111111111111
11111111111111111111111110001111111111010000000000000000000111111111111111111111111111111111111111110010001111111111111111111111111111111111111111111111111111111111111
11111111111111111100111110001111111111000000000000000000000111111111111111111111111111111111111111110000001111111111111111111111111111111111111111111111111111111111111
11111111111111111100111110001111111111000000000000000000000111111111111111111111111111111111111111110000001111111111111111111111111111111111111111111111111111111111111
11111111111111111100000000001111111111111111111100011111000111111111111111111111111111111111111111110000001111111111111111111111111111111111111111111111111111111111111
11111111111111111100000000001111111111111111111100011111000111111111111111111111111111111111111111111111111111111111111111111111111111111111111111111111111111111111111
11111111111111111100000000001111111111111111111100011111000111111111111100111111111111111111111111111111111111111111111111111111111111111111111111111111111111111111111
11111111111111111111111111111111111111111111111100011111000111111100111100111111111111111111111111111111111111111111111111111111111111111111111111111111111111111111111
11111111111111111111111111111111111111111111111100011111000111111100100000000111000111111111111111111111111111111111111111111111111111111111111111111111111111111111111
11111111111111111111111111111111111111111111111100011111000111111100000000000000000011111111111111111111111111111111111111111111111111111111111111111111111111111111111
11111111111111111111111111111111111111111111111100011111000111111100000000000000000001111111111111111111111111111111111111111111111111111111111111111111111111111111111
11111111111111111111111111111111111111111111111100011111000111111100000011100000000001111111111111111111111111111111111111111111111111111111111111111111111111111111111
11111111111111111111111111111111111111111111111100011111000111111110001111111111100001111111111111111111111111111111111111111111111111111111111111111111111111111111111
11111111111111111111111111111111100111111111111100011111000111111110001111111111100011111111111111111111111111111111111111111111111111111111111111111111111111111111111
11111111111111111111111111111111100111111111111100011111000111111100011111111111100001111111111111111110000000000000000000000000000000000000000001111111111111111111111
11111111111111111111111111111111100000000000000000011111000111111100001111111111110001111111111111111110000000000000000000000000000000000000000001111111111111111111111
11111111111111111111111111111111100000000000000000011111000111111100001111111001110001111111111111111110000000000000000000000000000000000000000001111111111111111111111
11111111111111111111111111111111100000000000000000011111000111111110001111111001110001111111111111111110001111111111111000111111100011111111110001111111111111111111111
11111111111111111111111111111111111111111111111100011111000111111100011111111000110001111111111111111110001111111111111000111111100011111111110001111111111111111111111
11111111111111111111111111111111111111111111111100011111000111111100000100011000100001111111111111111110001111111111111000111111100011111111110001111111111111111111111
11111111111111111111111111111111111111111111111100011111000111111100000000000000000001111111111111111110001111111111111000111111100011111111110001111111111111111111111
11111111111111111111111111111111111111111111111100011111000111111111000000000000000011111111111111111110001111111111111000111111100011111111110001111111111111111111111
11111111111111111111111111111111111111111111111100011111000111111111110001000111000111111111111111111110001111111111111000111111100011111111110001111111111111111111111
11111111111111111111111111111111111111111111111100011111000111111111111111111111111111111111111111111110001111111111111000111111100011111111110001111111111111111111111
11111111111111111111111111111111111111111111111100011111000111111111111111111111111111111111111111111110001111111111111000111111100011111111110001111111111111111111111
11111111111111111111111111111111111111111111111111111111000111111111111111111111111111111111111111111110001111111111111000111111100011111111110001111111111100111111111
11111111111111111111111111111111111111111111111111111111000111111111111111111111111111111111111111111110001111111111111000111111100011111111110001111111111100111111111
11111111111111111111111111111111111111111111111111111111000111111111111111111111111111111111111111111110001111111111111000111111100011111111110000000000000000000001111
11111111111111111111111111111111111111111111111111111111000111111111111111111111111111111111111111111110001111111111111000111111100011111111110000000000000000000001111
11111111111111111111111111111111111111111111111111111111000111111111111111111111111111111111111111111110001111111111111000111111100011111111110000000000000000000001111
11111111111111111111111111111111111111111111111111111111000111111111111111111111111111111111111111111110001111001100111000111111100011111111110001111111111111110001111
11111111111111111111111111111111111111111111111111111111000111111111111001111111111111111111111111111110001111001100111000111111100011111111110001111111111111110001111
11111111111111111111111111111111111111111111111111111111000111111111111001111111111111111111111111111110000000000000000000111111100011111111110001111111111111110001111
11111111111111111111111111111111111111111111111111111111000000000000000001111111111111111111111111111110000000000000000000111111100011111111110001111111111111110001111
11111111111111111111111111111111111111111111111111111111000000000000000001111111111111111111111111111110000000000000000000111111100011111111110001111111111111110001111
11111111111111111111111111111111111111111111111111111111000000000000000001111111111111111111111111111111111111110001111111111111100011111111110001111111111111110001111
11111111111111111111111111111111111111111111111111111111111111111111111111111111111111111111111111111111111111110001111111111111100011111111110001111111111111110001111
11111111111111111111111111111111111111111111111111111111111111111111111111111111111111111111111111111111111111110001111111111111100011111111110001111111111111110001111
11111111111111111111111111111111111111111111111111111111111111111111111111111111111111111111111111111111111111110001111111111111100011111111110001111111111111110001111
11111111111111111111111111111111111111111111111111111111111111111111111111111111111111111111111111111111111111110001111111111111100011111111110001111111111111110001111
11111111111111111111111111111111111111111111111111111111111111111111111111111111111111111111111111111111111111110001111111111111100011111111110001111111111111110001111
11111111111111111111111111111111111111111111111111111111111111111111111111111111111111111111111111111111111111110001111111111111100011111111110001111111111111110001111
11111111111111111111111111111111111111111111111111111111111111111111111111111111111111111111111111111111111111110001111111111111100011111111110001111111111111110001111
11111111111111111111111111111111111111111111111111111111111111111111111111111111111111111111111111111111111111110000000000000000000000000000000000000000011111110001111
11111111111111111111111111111111111111111111111111111111111111111111111111111111111111111111111111111111111111110000000000000000000000000000000000000000011111110001111
11111111111111111111111111111111111111111111111111111111111111111111111111111111111111111111111111111111111111110000000000000000000000000000000000000000000000000001111
11111111111111111111111111111111111111111111111111111111111111111111111111111111111111111111111111111111111111111111111100011111111111111111111111111100000000000001111
11111111111111111111111111111111111111111111111111111111111111111111111111111111111111111111111111111111111111111111111100011111111111111111111111111100000000000001111
11111111111111111111111111111111111111111111111111111111111111111111111111111111111111111111111111111111111111111111111100011111111111111111111111111100011111111111111
11111111111111111111111111111111111111111111111111111111111111111111111111111111111111111111111111111111111111111111111100011111111111111111111111111100011111111111111
11111111111111111111111111111111111111111111111111111111111111111111111111111111111111111111111111111111111111111111111100011111111111111111111111111100011111111111111
11111111111111111111111111111111111111111111111111111111111111111111111111111111111111111111111111111111111111111111111100011111111111111111111111111100011111111111111
11111111111111111111111111111111111111111111111111111111111111111111111111111111111111111111111111111111111111111111111100011111111111111111111111111100011111111111111
11111111111111111111111111111111111111111111111111111111111111111111111111111111111111111111111111111111111111111111111100011111111111111001111111111100011111111111111
11111111111111111111111111111111111111111111111111111111111111111111111111111111111111111111111111111111111111111111111100011111111111111001111111111100011111111111111
11111111111111111111111111111111111111111111111111111111111111111111111111111111111111111111111111111111111111111111111100000000000000000000000000000000011111111111111
11111111111111111111111111111111111111111111111111111111111111111111111111111111111111111111111111111111111111111111111100000000000000000000000000000000011111111111111
11111111111111111111111111111111111111111111111111111111111111111111111111111111111111111111111111111111111111111111111100000000000000000000000000000000011111111111111
11111111111111111111111111111111111111111111111111111111111111111111111111111111111111111111111111111111111111111111111111111111111111111111111111111111111111111111111
11111111111111111111111111111111111111111111111111111111111111111111111111111111111111111111111111111111111111111111111111111111111111111111111111111111111111111111111
11111111111111111111111111111111111111111111111111111111111111111111111111111111111111111111111111111111111111111111111111111111111111111111111111111111111111111111111
11111111111111111111111111111111111111111111111111111111111111111111111111111111111111111111111111111111111111111111111111111111111111111111111111111111111111111111111
11111111111111111111111111111111111111111111111111111111111111111111111111111111111111111111111111111111111111111111111111111111111111111111111111111111111111111111111